type octile
height 14
width 46
map
@@@@@@@@@@@@@@@@@@@@@@@@@@@@@@@@@@@@@@@@@@@@@@
@............................................@
@......@@@@@@@@@@.@@@@@@@@@@.@@@@@@@@@@......@
@......@@@@@@@@@@.@@@@@@@@@@.@@@@@@@@@@......@
@............................................@
@......@@@@@@@@@@.@@@@@@@@@@.@@@@@@@@@@......@
@......@@@@@@@@@@.@@@@@@@@@@.@@@@@@@@@@......@
@............................................@
@......@@@@@@@@@@.@@@@@@@@@@.@@@@@@@@@@......@
@......@@@@@@@@@@.@@@@@@@@@@.@@@@@@@@@@......@
@............................................@
@......@@@@@@@@@@.@@@@@@@@@@.@@@@@@@@@@......@
@......@@@@@@@@@@.@@@@@@@@@@.@@@@@@@@@@......@
@@@@@@@@@@@@@@@@@@@@@@@@@@@@@@@@@@@@@@@@@@@@@@
